x;x;x;x;x;x;x;x;x;x;x;x;x;x;x;x;x;x;x;x;x;x;x;x;x;x;x;x;x;x;x;x;x;x;x;x;x;x;x;x;x;x;x;x;x;x;x;x;x;x;x;x;x;x;x;x
x; ; ; ; ; ; ; ; ; ; ; ; ; ; ; ; ; ; ; ; ; ; ; ; ; ; ;;; ; ; ; ; ; ; ; ; ; ; ; ; ; ; ; ; ; ; ; ; ; ; ; ; ; ;x
x; ;*; ;*; ;*; ;*; ;*; ;*; ;*; ;*; ;*; ;*; ;*; ;*; ; ;;; ;*; ;*; ;*; ;*; ;*; ;*; ;*; ;*; ;*; ;*; ;*; ;*; ; ;x
x; ; ; ; ; ; ; ; ; ; ; ; ; ; ; ; ; ; ; ; ; ; ; ; ; ; ;;; ; ; ; ; ; ; ; ; ; ; ; ; ; ; ; ; ; ; ; ; ; ; ; ; ; ;x
x; ;*; ; ; ; ; ; ; ;;;;;;;;;;;;;;;;; ;;;;;;;;;;;;;;;;;;;; ; ; ; ; ; ;*; ; ;x
x; ; ; ; ;x;x;x;x;x;x;x;x;x;x;x;x;x;x;x;x;x;;;;;x;x;x;x;;;;;x;x;x;x;x;x;x;x;x;x;x;x;x;x;x;x;x; ; ; ; ;x
x; ;o; ; ;x;x;x;x;x;x;x;x;x;x;x;x;x;x;x;x;x;;;;;x;x;x;x;;;;;x;x;x;x;x;x;x;x;x;x;x;x;x;x;x;x;x; ;o; ; ;x
x; ; ; ; ;x;x;x;x;x;x;x;x;x;x;x;x;x;x;x;x;x;;;;;x;x;x;x;;;;;x;x;x;x;x;x;x;x;x;x;x;x;x;x;x;x;x; ; ; ; ;x
x; ;*; ; ;x;x;x;x;x;x;x;x;x;x;x;x;x;x;x;x;x;;;;;x;x;x;x;;;;;x;x;x;x;x;x;x;x;x;x;x;x;x;x;x;x;x; ;*; ; ;x
x; ; ; ; ; ; ; ; ; ; ; ; ; ; ; ; ; ; ; ; ; ; ; ; ; ; ; ; ; ; ; ; ; ; ; ; ; ; ; ; ; ; ; ; ; ; ; ; ; ; ; ; ; ; ;x
x; ;*; ;*; ;*; ;*; ;*; ;o; ;*; ;*; ;*; ;*; ;*; ;*; ;*; ;*; ;*; ;*; ;*; ;*; ;*; ;*; ;o; ;*; ;*; ;*; ;*; ;*; ; ;x
x;;;; ; ; ; ; ; ; ; ;;; ; ; ; ; ; ; ; ; ; ; ; ; ; ; ; ; ; ; ; ; ; ; ; ; ; ; ; ; ; ; ; ; ; ; ; ; ; ; ; ; ;x
x;;;; ; ; ; ; ; ; ; ;;; ; ; ; ;*; ; ; ; ; ; ; ; ; ; ; ; ; ; ; ; ; ;*; ; ; ; ; ;; ; ; ; ; ; ; ; ; ;;; ;x
x;;;; ;x;x;x;x;x;x; ;;; ;x;x; ; ; ; ;x;x;x;x;x;x;x;x;x;x;x;x;x;x; ; ; ; ;x;x; ;; ; ;x;x;x;x;x;x; ;;; ;x
x;;;; ;x;x;x;x;x;x; ;;; ;x;x; ;*; ; ;x;x;x;x;x;x;x;x;x;x;x;x;x;x; ;*; ; ;x;x; ;; ; ;x;x;x;x;x;x; ;;; ;x
x; ; ; ; ; ; ; ; ; ; ; ; ; ; ;x;x; ; ; ; ; ; ; ; ; ; ;x;x; ; ; ; ; ; ; ; ; ; ;x;x; ; ; ; ; ; ; ; ; ; ; ; ; ; ;x
x; ;*; ;*; ;*; ;*; ;*; ;o; ; ;x;x; ;*; ;*; ;*; ;*; ; ;x;x; ;*; ;*; ;*; ;*; ; ;x;x; ;o; ;*; ;*; ;*; ;*; ;*; ; ;x
x; ; ; ; ; ; ; ; ; ; ; ; ; ; ;x;x; ; ; ; ; ; ; ; ; ; ;x;x; ; ; ; ; ; ; ; ; ; ;x;x; ; ; ; ; ; ; ; ; ; ; ; ; ; ;x
x; ; ; ; ; ; ; ; ; ; ; ;*; ; ;x;x; ; ; ; ; ; ; ; ; ; ;x;x; ; ; ; ; ; ; ; ; ; ;x;x; ;*; ; ; ; ; ; ; ; ; ; ; ; ;x
x;;;;;x;x;x;x;x;x; ; ; ; ;x;x;x;x;x;x;x;x; ; ; ; ;x;x; ; ; ; ;x;x;x;x;x;x;x;x; ; ; ; ;x;x;x;x;x;x;;;;;x
x;;;;;x;x;x;x;x;x; ;*; ; ;x;x;x;x;x;x;x;x; ; ; ; ;x;x; ; ; ; ;x;x;x;x;x;x;x;x; ;*; ; ;x;x;x;x;x;x;;;;;x
x;;;;;x;x;x;x;x;x; ; ; ; ;x;x; ; ; ; ; ; ; ; ; ;b; ; ; ; ; ; ; ; ; ; ; ; ;x;x; ; ; ; ;x;x;x;x;x;x;;;;;x
x;;;;;x;x;x;x;x;x; ;*; ; ;x;x; ; ; ; ; ; ; ; ; ; ; ; ; ; ; ; ; ; ; ; ; ; ;x;x; ;*; ; ;x;x;x;x;x;x;;;;;x
x;;;;;x;x;x;x;x;x; ; ; ; ;x;x; ; ; ; ; ; ; ; ; ; ; ; ; ; ; ; ; ; ; ; ; ; ;x;x; ; ; ; ;x;x;x;x;x;x;;;;;x
x;;;;;x;x;x;x;x;x; ;*; ; ;x;x; ; ; ; ; ; ; ; ; ; ; ; ; ; ; ; ; ; ; ; ; ; ;x;x; ;*; ; ;x;x;x;x;x;x;;;;;x
x;;;;;x;x;x;x;x;x; ; ; ; ;x;x; ; ; ; ;x;x;x;x;x;-;-;-;-;x;x;x;x;x; ; ; ; ;x;x; ; ; ; ;x;x;x;x;x;x;;;;;x
x;;;;;x;x;x;x;x;x; ;*; ; ;x;x; ; ; ; ;x; ; ; ; ; ; ; ; ; ; ; ; ;x; ; ; ; ;x;x; ;*; ; ;x;x;x;x;x;x;;;;;x
x; ; ; ; ; ; ; ; ; ; ; ; ; ; ; ; ; ; ; ; ;x;p; ; ; ;i; ; ; ;c; ; ; ;x; ; ; ; ; ; ; ; ; ; ; ; ; ; ; ; ; ; ; ; ;x
x; ; ; ; ; ; ; ; ; ; ; ;*; ; ; ; ; ; ; ; ;x; ; ; ; ; ; ; ; ; ; ; ; ;x; ; ; ; ; ; ; ;*; ; ; ; ; ; ; ; ; ; ; ; ;x
x; ; ; ; ; ; ; ; ; ; ; ; ; ; ; ; ; ; ; ; ;x; ; ; ; ; ; ; ; ; ; ; ; ;x; ; ; ; ; ; ; ; ; ; ; ; ; ; ; ; ; ; ; ; ;x
x; ; ; ; ; ; ; ; ; ; ; ;*; ; ; ; ; ; ; ; ;x; ; ; ; ; ; ; ; ; ; ; ; ;x; ; ; ; ; ; ; ;*; ; ; ; ; ; ; ; ; ; ; ; ;x
x;;;;;x;x;x;x;x;x; ; ; ; ;x;x; ; ; ; ;x; ; ; ; ; ; ; ; ; ; ; ; ;x; ; ; ; ;x;x; ; ; ; ;x;x;x;x;x;x;;;;;x
x;;;;;x;x;x;x;x;x; ;*; ; ;x;x; ; ; ; ;x;x;x;x;x;x;x;x;x;x;x;x;x;x; ; ; ; ;x;x; ;*; ; ;x;x;x;x;x;x;;;;;x
x;;;;;x;x;x;x;x;x; ; ; ; ;x;x; ; ; ; ; ; ; ; ; ; ; ; ; ; ; ; ; ; ; ; ; ; ;x;x; ; ; ; ;x;x;x;x;x;x;;;;;x
x;;;;;x;x;x;x;x;x; ;*; ; ;x;x; ; ; ; ; ; ; ; ; ; ; ; ; ; ; ; ; ; ; ; ; ; ;x;x; ;*; ; ;x;x;x;x;x;x;;;;;x
x;;;;;x;x;x;x;x;x; ; ; ; ;x;x; ; ; ; ; ; ; ; ; ; ; ; ; ; ; ; ; ; ; ; ; ; ;x;x; ; ; ; ;x;x;x;x;x;x;;;;;x
x;;;;;x;x;x;x;x;x; ;*; ; ;x;x; ; ; ; ; ; ; ; ; ; ; ; ; ; ; ; ; ; ; ; ; ; ;x;x; ;*; ; ;x;x;x;x;x;x;;;;;x
x;;;;;x;x;x;x;x;x; ; ; ; ;x;x; ; ; ; ;x;x;x;x;x;x;x;x;x;x;x;x;x;x; ; ; ; ;x;x; ; ; ; ;x;x;x;x;x;x;;;;;x
x;;;;;x;x;x;x;x;x; ;*; ; ;x;x; ; ; ; ;x;x;x;x;x;x;x;x;x;x;x;x;x;x; ; ; ; ;x;x; ;*; ; ;x;x;x;x;x;x;;;;;x
x; ; ; ; ; ; ; ; ; ; ; ; ; ; ; ; ; ; ; ; ; ; ; ; ; ;;;;; ; ; ; ; ; ; ; ; ; ; ; ; ; ; ; ; ; ; ; ; ; ; ; ; ;x
x; ;*; ;*; ;*; ;*; ;*; ;o; ;*; ;*; ;*; ;*; ;*; ;*; ;;;;;*; ;*; ;*; ;*; ;*; ;*; ;o; ;*; ;*; ;*; ;*; ;*; ; ;x
x; ; ; ; ; ; ; ; ; ; ; ; ; ; ; ; ; ; ; ; ; ; ; ; ; ;;;;; ; ; ; ; ; ; ; ; ; ; ; ; ; ; ; ; ; ; ; ; ; ; ; ; ;x
x; ;*; ; ; ; ; ; ; ; ; ;; ; ; ; ; ; ; ; ; ; ;;;;;;;;;;;;;;;;;;;;;;; ; ; ; ; ; ; ;*; ; ;x
x; ; ; ; ;x;x;x;x;x;x;x;x;x;x;x;x;x;x;x;x;x;x; ; ; ;;;;; ; ; ;x;x;x;x;x;x;x;x;x;x;x;x;x;x;x;x;x;x; ; ; ; ;x
x; ;*; ; ;x;x;x;x;x;x;x;x;x;x;x;x;x;x;x;x;x;x; ;;;;;;;; ; ;x;x;x;x;x;x;x;x;x;x;x;x;x;x;x;x;x;x; ;*; ; ;x
x; ; ; ; ; ; ; ;;;;;;;; ; ; ; ; ; ; ; ; ; ; ;P; ; ; ; ; ; ; ; ; ; ; ; ; ; ; ; ;;;;;;;;; ; ; ; ;x
x; ;o;;;;;;;;;;;;; ;*; ;*; ;*; ;*; ;*; ; ; ; ; ;*; ;*; ;*; ;*; ;*; ;*; ;;;;;;;;;; ;o; ; ;x
x; ; ;;;;;;;;;;;;; ; ; ; ; ; ; ; ; ; ; ; ; ; ; ; ; ; ; ; ; ; ; ; ; ; ; ;;;;;;;;;; ; ; ; ;x
x; ; ;;;;;;;;;;;;; ; ; ;o; ; ; ; ; ; ; ; ; ; ; ; ; ; ; ; ; ;o; ; ; ; ; ;;;;;;;;;;;;;;x
x;;*;;;;;;;;;;;; ;x;x; ; ; ; ;x;x;x;x;x;x;x;x;x;x;x;x;x;x; ; ; ; ;x;x; ;;;;;;;;;;;*;;;x
x;;;;;;;;;;;;;; ;x;x; ;; ; ;x;x;x;x;x;x;x;x;x;x;x;x;x;x; ;; ; ;x;x; ;;;;;;;;;;;;;;x
x; ; ;;;;;;;;;;;; ;x;x; ; ; ; ; ; ; ; ; ; ;x;x; ; ; ; ; ; ; ; ; ; ;x;x; ;;;;;;;;;;;;;;x
x; ;*;;;;;;;;;;;; ;x;x; ;*; ;*; ;*; ;*; ; ;x;x; ;*; ;*; ;*; ;*; ; ;x;x; ;;;;;;;;;; ;*; ; ;x
x; ; ;;;;;; ; ; ; ; ; ; ;x;x; ; ; ; ; ; ; ; ; ; ;x;x; ; ; ; ; ; ; ; ; ; ;x;x; ;;;;;;;;;; ; ; ; ;x
x; ;*; ; ; ; ; ; ; ; ; ; ; ; ;x;x; ; ; ; ; ; ; ;; ; ;x;x; ;; ; ; ; ; ; ; ; ;x;x; ; ; ; ; ; ;;;;; ;*; ; ;x
x; ; ; ; ;x;x;x;x;x;x;x;x;x;x;x;x;x;x;x;x;x;x; ; ; ; ;x;x; ; ; ; ;x;x;x;x;x;x;x;x;x;x;x;x;x;x;x;x;x;x; ; ; ; ;x
x; ;*; ; ;x;x;x;x;x;x;x;x;x;x;x;x;x;x;x;x;x;x; ;; ; ;x;x; ;; ; ;x;x;x;x;x;x;x;x;x;x;x;x;x;x;x;x;x;x; ;*; ; ;x
x; ; ; ; ; ; ; ; ; ; ; ; ; ; ; ; ; ; ; ; ; ; ; ; ; ; ; ; ; ; ; ; ; ; ; ; ; ; ; ; ; ; ; ; ; ; ; ; ; ; ; ; ; ; ;x
x; ;*; ;*; ;*; ;*; ;*; ;*; ;*; ;*; ;*; ;*; ;*; ;*; ;*; ;*; ;*; ;*; ;*; ;*; ;*; ;*; ;*; ;*; ;*; ;*; ;*; ;*; ; ;x
x; ; ; ; ; ; ; ; ; ; ; ; ; ; ; ; ; ; ; ; ; ; ; ; ; ; ; ; ; ; ; ; ; ; ; ; ; ; ; ; ; ; ; ; ; ; ; ; ; ; ; ; ; ; ;x
x; ; ; ; ; ; ; ; ; ; ; ; ; ; ; ; ; ; ; ; ; ; ; ; ; ; ; ; ; ; ; ; ; ; ; ; ; ; ; ; ; ; ; ; ; ; ; ; ; ; ; ; ; ; ;x
x;x;x;x;x;x;x;x;x;x;x;x;x;x;x;x;x;x;x;x;x;x;x;x;x;x;x;x;x;x;x;x;x;x;x;x;x;x;x;x;x;x;x;x;x;x;x;x;x;x;x;x;x;x;x;x
